  ┌────────────────────┐
  │    TEST STAND      │
  │  ╔══════════╗      │
  │  ║  ENGINE  ║      │
  │  ╚════╤═════╝      │
  │    ╔══╧══╗         │
  │   ╔╝    ╚╗         │
  │  ╔╝ ▼▼▼▼ ╚╗       │
  │  ║ *FLAME* ║← 3400C
  │  ║ * ▼▼▼ * ║       │
  │  ╚═════════╝       │
  └────────────────────┘
  THRUST: 845kN  PASS
