  ╔═══════════════════╗
  ║   PRESS  50 TON   ║
  ║   ╔═══════════╗   ║
  ║   ║ ▼▼▼▼▼▼▼▼▼ ║   ║
  ║   ╠═══════════╣   ║
  ║   ║ ░░░░░░░░░ ║   ║
  ║   ║  AL SHEET  ║   ║
  ║   ╚═══════════╝   ║
  ╚═══════════════════╝
    ┌─────────────────┐
    │ FORMED PANEL OK │
    └─────────────────┘
  THICKNESS: 2.4mm PASS
